A0A0A0A0A0A0A0B0B0A0A0A0A0A0A0A0
A0A0A0A0A0A0B0A0A0B0A0A0A0A0A0A0
A0A0A0A0A0B0A0A0A0A0B0A0A0A0A0A0
A0A0A0A0B0A0A0A0A0A0A0B0A0A0A0A0
A0A0A0B1A0A0A0A0A0A0A0A0B1A0A0A0
A0A0B0A0A0A0A0A0A0A0A0A0A0B0A0A0
A0B0A0A0A0A0A0A0A0A0A0A0A0A0B0A0
B0B0B0B0B0B0B0B0B0B0B0B0B0B0B0B0