AAAAAAAB
AAAAAABA
AAAAABAA
AAAABAAA
AAABAAAA
AABAAAAA
ABAAAAAA
BBBBBBBB